#################
#               #
#               #
#  P X    O     #
#               #
#               #
#################