#################
#               #
#@@@@@@@@@@@@@@@#
#@       ^ O~~~@#
#@ P X   ^  ~B @#
#@  ^       ~~~@#
#@ @@@@@@@@ @@@@#
#               #
#################