#################
#               #
#@@@@@@@@@@@@@@@#
#@       ^     @#
#@ P X    O    @#
#@  ^  ^       @#
#@@@@@@@@@@@@@@@#
#               #
#################