    #######
    #   XO#
##### #####
#    *    #
#   * *   #
#  * * *  #
# * * * * #
#* * * * *#
# * * * * #
#  * * *  #
#   * *   #
#    *    #
##### #####
#P    #    
#######    