#######        #######
#    O#        #     #
#  XX ##########OXX  #
#   XO   OOOO   OX  P#
#  XX ##########OXX  #
#    O#        #     #
#######        #######