##########
#    ##  #
# X O ## #
#  O O ###
# O O X ##
## O X X #
### X P  #
# ## X  ##
#  ##  ###
##########