    ####  
 ####  #  
 #  X  ###
 #  #    #
 #P #    #
##### ####
#     O # 
#  #    # 
#  #### ##
#        #
#  ### # #
#### #   #
     #####