       ####
   #####  #
####      #
#OOOOOOO  #
####  #   #
  ### #####
  #  X  #  
  #  X  #  
  ##X X##  
   # X #   
   #X X#   
   # P #   
   #####   