    #####    
   ## P ##   
  ##  #  ##  
 ##  X X  ## 
##  # # #  ##
#OO* X X *OO#
# # # # # # #
#OO* X X *OO#
##  # # #  ##
 ##  X X  ## 
  ##  #  ##  
   ##   ##   
    #####    