#############
#   ##     ##
#  * # XXX ##
## # # X O ##
#  # # OOO ##
# X# ####*###
# O#  ##    #
##   *P#  # #
######      #
#############