 ######## 
##  #   ##
#O X     #
# #X####P#
# #  XOX #
# #O #   #
# #X ###O#
# #O### X#
# #   #  #
#  O XO  #
##########