     ######## 
######     P# 
#      #X## # 
# #X## #O X # 
# # OX X O# # 
# XO # ## # ##
# ## #OO     #
#     OO# ## #
## # ## # OX #
 # #O X XO # #
 # X O# ##X# #
 # ##X#      #
 #      ######
 ########     