 ###### 
 ###### 
  # O#  
  #XO#  
  # O#  
  #XO#  
  # O#  
 ##XO## 
### O###
## X  ##
## XP ##
## XX ##
##    ##
 ###### 