 ####        
##  #########
#  X X X XP #
#  O O O O  #
##  #########
 ####     # #