###############
##OO O O O OO##
 ## X  P  X ## 
  ## XXXXX ##  
   ##     ##   
    ##   ##    
     ## ##     
      ###      