#             #
 ##  #####  ## 
  ####   ####  
   ###* *###   
   #  XOX  #   
   #  O O  #   
   ## XOX ##   
    ## P ##    
     #####     
      ###      
       #       
       #       