  ####  
  #  #  
###XO###
# O  X #
# X  O #
### P###
# O  X #
# X  O #
###OX###
  #  #  
  ####  