    #######    
    #     #    
    # POO #    
    #   # #    
###### ########
#   #     #   #
# X## OOO # X #
# X   *O*   X #
# X # OOO ##X #
#   #     #   #
####### #######
    # #   #    
    # XXX #    
    #     #    
    #######    