##########
#        #
# X X X  #
#######*P#
# * * *  #
# O O O  #
##########