#########
#       #
# XXXX* #
# X   O #
# X ##O #
# X ##O #
# *OOOO #
#      P#
#########