####  #####    
#  ####   #    
#       P #####
#  ##  #X##   #
#     ## O    #
##### #### ####
#          #   
#   ####   #   
#####  #####   