###############
# O    P    O #
# OX X X X XO #
##O#########O##
# OX X X X XO #
# O         O #
###############