 ######## 
 #  P   # 
 #X X X # 
 # #O#### 
## OOO  ##
#  #O#   #
#  X X   #
#######  #
      ####