##########
# O O O  #
# X X X  #
####### *#
#PX X X  #
# O O O  #
##########