      ###      
#######O#######
#     O*O     #
#PXXXXO*OXXXX #
#     O*O     #
#######O#######
      ###      