    #### 
    #  # 
    #  # 
    #  # 
###### # 
#      # 
#   # O# 
##### ###
    # #P#
    # # #
    #X# #
    #   #
    #####