###########
#  #   #  #
#  *   *  #
#  ##P##  #
#O##   ##O#
#  X * X  #
#O##   ##O#
#  ##X##  #
#X *   *  #
#  #   #  #
###########