 #####   
 #   ####
 # OX   #
## # X# #
#OXOX # #
# #X X# #
#OXO O# #
#   ### #
###O#   #
  #   P #
  #######