       #####  
    ####   #  
#####   X# #  
#   # #O*  ###
#   X XOOOO  #
#######X#X## #
      #  P   #
      ########