 ####### 
 #*O*O*# 
 #O*O*O# 
 #*O*O*# 
 #O*O*O# 
 #*O*O*# 
 # XOX # 
 #  X  # 
####P####
#       #
# X X X #
## X X ##
 #X X X# 
 # X X # 
 #     # 
 ####### 