         #####   
       ### XO##  
     ### * X* ## 
   ###  *  XO  # 
  ##OO * * XOX ##
####OP* *  XOX ##
  ##OO * * XOX ##
   ###  *  XO  # 
     ### * X* ## 
       ### XO##  
         #####   