###########
#    P    #
# X X X X #
##       ##
 ## X X ## 
  ##OOO##  
   ##O##   
    #O#    
    #O#    
    #O#    
    #O#    
   ##O##   
  ##OOO##  
 ## X X ## 
##       ##
# X X X X #
#         #
###########