##########
#OOOOOOOP#
# X##O#X #
#  X     #
## ##X#X##
#  #  #  #
# XX  X  #
#  #  #  #
##########