###########
#   O  #  #
##  #X    #
#  X O#X  #
#  #    #O#
# XO # OX #
#O#    #  #
#  X#O X ##
#    X#   #
#P #  O   #
###########