#####    #####
#   ######   #
# X          #
#  X X X X X #
## ######### #
# *O*O*OOO # #
# OOOOO*O* #P#
######### ## #
# X X X X  # #
#        X # #
#   #####    #
#####   ######