#######################
####################  #
#          X         O#
#PXXXXXXXXXXOOOOOOOOOO#
#           ###########
#######################