#######          
#   # ## ###     
#   ###### ##    
##       ########
 #XXX X XOO*OO*O#
 # PXXXXXOO*OO*O#
 #XXX X XOO*OO*O#
 #       ########
 ###  #### ##    
  ##  #  ###     
   ####          