#########
#   P   #
# XXXXX #
# X   X #
# X   X #
#### ####
# X X X #
#OOOOOOO#
# OOOOO #
#       #
### # ###
# ***** #
#       #
#       #
#####  ##
#########