#########################
#     #*****#    *#     #
# OOO #*   *# * * #     #
# OOO  *   *   *   *****#
# OO  #*   *# * * #     #
#     #*****#*    #     #
### ################# ###
#  *  # *   #*    #  X  #
# *   # * * # * * # X X #
#*   *    *   **   X  X #
# * * # * * # * * # XXX #
#  *  #   * #    *#    P#
#########################