  #######
  # OOOO#
###XXXXO#
# * *  O#
# # # XO#
# P * X #
# # # X #
#     ###
#######  