 ######### 
## #O#O#O##
#PX X X XO#
## # #*#O##
 # * * X # 
 # # # # # 
 #       # 
 ######### 