   ########## 
  ##    #   # 
 ##  P    X # 
 # XXXXX##X## 
 # X    O# #  
 #  ###OO# ## 
 # ## OOO#  ##
 #   OOOO# X #
#####OO### X #
#      # XX  #
#           ##
############# 