##############
#            #
#  # # # # # #
# ********XO #
#            #
##############