########
#P     #
#OOOXXX#
# #  # #
#XXXOOO#
# #  # #
# #  # #
# #### #
#      #
########