 ########### 
#############
##         ##
#           #
## XXXXXXX ##
 ##       ## 
  ## XXX ##  
   ##   ##   
######P######
   #OOOOO#   
####OOOOO####
   #     #   
####     ####
   #######   
    #####    