    #####  
    #   #  
##### X #  
#   # X #  
# XXOOO####
#   OPO   #
####OOOXX #
  # X #   #
  # X #####
  #   #    
  #####    