###############
#          O  #
# ######### # #
# O   *    O  #
###XXXXXXX#O###
# O   *    O  #
# ######### # #
#          O  #
###############