    ###    
   #   #   
  #  O  #  
 #  * *  # 
#  * * *  #
# * * * * #
#  * * *  #
 #  * *  # 
  #  X  #  
   # P #   
    ###    