#########
#       #
# X X X #
#  # #  #
# X X X #
#  # #  #
# X X X #
#       #
####P####
# OOOOO #
#  OOO  #
#   O   #
#########