  #   #   #      
  #   #   #      
 ############   #
 #       #  ## # 
## X*X*X  O ###  
##       #OO##   
###X#X#X#*OOO#   
##       #OO##   
## X*X*X  O ###  
 #       #  ## # 
 ############   #
  #   #   #      
  #   #   #      