  #######
  #   # #
  #   O #
  # #*  #
  # * # #
###*  # #
# *  ## #
# X#    #
# P######
####     