        #####  
        #   #  
  ####### # #  
  #         #  
### ### ### #  
#   # # # # #  
# #X### ###X###
#    X P X    #
###X#######X# #
  # OOOOOOO   #
  # ####### ###
  #    X    #  
  # # #######  
  #   #        
  #####        