        ###        
#####   #O#####    
#PXO# ###X  XO#    
## ####O# ## ####  
 #X XO#X XO#X XO#  
 #O# ## ####O# ####
 ###X  XO#O###X XO#
   #O#####XXO#O# ##
  ####      #### # 
  #O X X###O#OX X# 
  ##X## #O#### #O# 
   #O#OX X#OX X### 
   ###### ## #O#   
       #OX  X###   
       #####O#     
           ###     