###################
#P     OO##       #
# XXXX OOOO XXXX  #
#      ##OO       #
###################