      ####### 
      #     # 
####### # # # 
#O O OXX X X##
# # # # #O#  #
#O*O*OOX XXXP#
# # # # #O#  #
#O O OXX X X##
####### # # # 
      #     # 
      ####### 