##########
#        #
# X X XX #
###### X #
   ##    #
  ##OOO ##
 ##OOOO## 
## OOO##  
#    ##   
# X ######
# XX X X #
#        #
##########