###########
#         #
#  X X X  #
# XPX X X #
#  X ######
# X X#     
#  X #     
# X X######
#  X     O#
# #X##### #
# #OOOOOX #
# #O###O# #
# #O#*#O# #
# #O###O# #
# XOOOOO# #
# #####X# #
#O        #
###########