#########
#~~~P~~~#
#~~~ ~~~#
#~~  ~~~#
#~  ~~~~#
#~X~~~~O#
#~ ~~~~ #
#~ ~~~~ #
#~ ~~   #
#~ ~    #
#~ ~   ~#
#  ~~ ~~#
#     ~~#
#~~~  ~~#
#########