#########
#~~~P~~~#
#~~~ ~~~#
#~~  ~~~#
#~  ~~~~#
#~X~~~~O#
#~ ~ ~~ #
#~ ~~~  #
#~ ~~   #
#~ ~    #
#~ ~   ~#
#  ~~  ~#
#     ~~#
#~    ~~#
#########