           ######           
############  * #      #####
#O  P  X      * ########   #
############  *            #
           #  * ########   #
           ######      #####