##############
#P           #
# OX*OX*OX*O #
# *        X #
# X ###### * #
##O #    # O##
# * ###### X #
# X        * #
# O*XO*XO*XO #
#            #
##############