  #####              
###   ###            
#   X   #            
# XXXXX #            
#   X   #            
### X# ##     #######
  #  # #      #O O  #
  # X# #      #O O  #
  #  # #      #O O  #
  #X## ########O O  #
  # #          O O  #
  # #    ######O##P##
  # #### #    #O    #
  # X X  #    #######
  #     ##           
  #######            