############    
#          #    
#********  #    
#O      *  #    
#****** *  #    
#     * *  #####
##### * *      #
    # * *******#
    # *      XP#
    # *  ******#
    # ****     #
    #          #
    ############