########################
#                      #
# #X################## #
# #                  # #
# # #X############## # #
# # #              X XP#
# # # ############ # # #
# # # #OOOOOOOOOOX X # #
# # # ############ # # #
# # X              # # #
# # ##############X# # #
# X                  # #
# ##################X# #
#                      #
########################