#########
#  * * ##
#  X X  #
# O*O*O #
#  XPX  #
# O*O*O #
#  X X  #
## * *  #
#########