    #####    
   ##   ##   
 #### X #### 
#####   #####
#   ## ##   #
#  X     X  #
# X ## ## X #
## ###O### ##
##  # O ## ##
#   OOOOO  ##
#   # O ## ##
## ###O### ##
# X #   # X #
#  X  #  X  #
#   #####   #
#####   #####
 ####   #### 
   ##   ##   
    #####    