##########
#       P#
# X##### #
#  #OOO# #
# XXOOO# #
#  #OOOX #
# X##X## #
#  X X X #
#        #
##########