  #######  
  #  P  #  
  # # # #  
  #     #  
  # ### #  
  #  O  #  
  ### ###  
    #O#    
##### #####
#O X   X O#
# # OXO # #
# #XXXXX# #
# #  X  # #
# #  X  # #
###O###O###
  # # # #  
  # # # #  
  # # # #  
  # # # #  
  #O# #O#  
  ### ###  