      #######      
      #  P  #      
      # # # #      
      #     #      
      # ### #      
      #     #      
      ###O###      
        #O#        
#########O#########
#OO    X   X    OO#
####### X X #######
      #X X X#      
      # X X #      
      #X   X#      
      # ### #      
      # # # #      
      # # # #      
      # # # #      
      #O# #O#      
      #O# #O#      
      ### ###      