 ###########  
 #         #  
 # X X # #O#  
 #XXXX # #O#  
 #  X  # #O## 
 # X X #P#O # 
 # #######  # 
 # #        # 
 # # # # # ###
##O#       ###
# O#######  # 
#OOO        # 
#########   # 
        ##### 