                           ########
                        ####      #
                     ####    #### #
                  ####    #### P# #
               ####    ####  # X  #
            ####    ####  #    O###
         ####    ####  #     #    #
      ####    ####  #     #  #### #
   ####    ####  #     #  ####    #
####    ####  #     #  ####    ####
#    ####  #     #  ####    ####   
# ####  #     #  ####    ####      
# #  #     #  ####    ####         
# #     #  ####    ####            
# #OX#  ####    ####               
# #  ####    ####                  
# ####    ####                     
#      ####                        
########                           