      #############      
      #  *  *  *  #      
#######  *  *  *  #######
#P  *    *  *  *    X  O#
#######  *  *  *  #######
      #  *  *  *  #      
      #############      