######   ######
#    #####    #
# XOX  P  OXO #
# O O#####X X #
# XOX     OXO #
#    #####    #
######   ######