     #####     
 #####   #     
 #       #     
 # ###   #     
 # #*## ##     
## ##*#X#*#####
#   ###O###   #
#    XOPOX    #
#   ###O###   #
#####*#X#*#####
     ## ##     
     #   #     
     #   #     
     #   #     
     #####     