 #### # #    #### 
##  ##########  ##
#                #
#  #  #########  #
## #####******# ##
 # #   ########  #
 # #    XOPOX    #
## #   #######  ##
#  ######   ######
#          X##***#
##  ##### #  #***#
#####   #X   #####
#  #O O    ###   #
## #########   ###