     #####           
 #####   ############
 #                  #
 # ###   ########## #
 # # ## ##        # #
 # #  # #   ##### # #
 # #  #X#####   # # #
##### #O OX   P # # #
#   ###   ###   # # #
#     XO O# ##### # #
#   ####X##  # #  # #
#####  # ##### #### #
       #            #
       ##############