 # # # # ###  
         #  # 
####### # *  #
#O O O## *   #
# XXX # * *  #
#OXPXO   * XO#
# XXX # * *  #
#O O O## *   #
####### # *  #
         #  # 
 # # # # ###  