####      
#  #######
#        #
#  #XXXXX#
# ##OOOOO#
#  #     #
## #### ##
# *   #  #
#   #   P#
##########