       ####        
######## P####     
#OOO X  X OOO###   
#### XX#   ### #   
   #   # X##     # 
 # ###### ##### ## 
 #  # #     #O# #  
###   # X X #O#### 
#O# ### X X #O#  # 
#O# #    X       # 
#O### ###### X # # 
#     #    ## ## # 
#  X ## ####   # ##
# XX #  #OOOX     #
##   ## ####      #
 #####     ########