###################
#        P        #
# XXXXXXXXXXXXXXX #
# XOOOOOOOOOOOOOX #
# XOXXXXXXXXXXXOX #
# XOXOOOOOOOOOXOX #
# XOXOOOOOOOOOXOX #
# XOXOOXXXXXOOXOX #
# XOXOOXOOOXOOXOX #
# XOXOOXO OXOOXOX #
# XOXOOXOOOXOOXOX #
# XOXOOXXXXXOOXOX #
# XOXOOOOOOOOOXOX #
# XOXOOOOOOOOOXOX #
# XOXXXXXXXXXXXOX #
# XOOOOOOOOOOOOOX #
# XXXXXXXXXXXXXXX #
#                 #
###################