        #        
       ###       
      ##O## ###  
     ##OOO### #  
    ##OOOOO## #  
   ##OOOOOOO###  
  ##OO     OO##  
 ##O         O## 
########P########
 #     X X     # 
 # ### X X ### # 
 # #*# X X #*# # 
 # ### X X ### # 
 # X X     X X # 
 # X X ### X X # 
 # X X#***#X X # 
 # X  ##**#  X # 
 #    #***#    # 
 ############### 