      ####      
      #  #      
      #  #      
      #  #      
#######XO#######
#  O O OX X X  #
#  X X XO O O  #
#######OX#######
      #  #      
      #OX#      
  #   #  #   #  
  #   #OX#   #  
##### #  # #####
  #   #OX#   #  
  #   #  #   #  
  #   # P#   #  
  #  ######  #  
  # ######## #  
  ############  
  ############  
 ############## 
################