    #####          
    #   #          
    #X  #          
  ###  X##         
  #  X X #         
### # ## #   ######
#   # ## #####O  O#
# X  X       XOOOO#
#####X### #P##O  O#
    #     #########
    #######        