       ############
       #          #
       # ######## #
    #### #   #  # #
    #    #   X  # #
    # #####X##  # #
 #### #   #  #O## #
 #    #   X  #O#  #
 # #####X##  #O# ##
## #   #  ####O# # 
#  #   X  #  #O# # 
# ###X##  #  #O# # 
#   #  #######O# # 
#   X  #       # # 
##P##  #       # # 
#   ####       * # 
#              # # 
################## 