#################
##      P      ##
## ########### ##
##XXO#######   ##
##OXXO#####  X ##
###OXXO###  X ###
####OXXO#  X ####
#####OXXO X #####
######OXXO ######
###### OXXO######
##### O OXXO#####
#### O  #OXXO####
### O  ###OXXO###
## O  #####OXXO##
#    #######OXXO#
#   #########O  #
# ############# #
#               #
#################