#######             
# X O #####         
# OPX     #         
# X O ### #    #####
####### # #    #   #
        # #    # X #
#### #### #### #   #
#  # #       # ## ##
#  # # * * * # #   #
#O # #* * * *# # * #
# X# # * * * # #   #
# O# #* * * *# ## ##
#X # #       # #   #
#O # #       # # * #
# X# #### #### #   #
# O#    # #    ## ##
#X ###### ######   #
#        O       * #
################   #
               #####