#########
#   #   #
# XO OX #
#   #   #
## ###P##
#   #   #
# XO OX #
#   #   #
#########