#############
#  OX # XO  #
# X  OPO  X #
#  OX # XO  #
#############