       ########   
       #   #  #   
       #      #   
    ##### ##  ####
    #   # #  ##  #
    #     #      #
    ## #  #####  #
    #  ####   # ##
 ####         # # 
 #  #  ##### ## # 
 #  ####   #  # # 
 #    O#      # # 
 ## ##### ##  # # 
  # #   #  #### ##
### #      #  #  #
#   ##X##  #     #
# # # P #### #####
#   # # #  #  #   
##            #   
 #  ###########   
 ####             