#   #               ########
##  ##         ####### OX  #
### ###  ######## *  # OX  #
########### XO  # *  # OX  #
#   # XO  # XO  # *  # OX  #
#PX O XO    XO    *    OX  #
############################