###########################
#    #       #       #    #
# ******* ******* ******* #
# *     O *     * O     * #
# * XXX O *  P  * O XXX * #
##* X   O O     O O   X *##
# * X ******* ******* X * #
# *   * * O O O O * *   * #
# ***O*** ******* ***O*** #
#     *     * *     *     #
##### * XXX * * XXX * #####
    # *     O O     * #    
    # ******* ******* #    
    #    #       #    #    
    ###################    