     ####
######  #
#   ##X #
# XO O  #
### P ###
# XO O  #
#   ##X #
######  #
     ####