############
#          #
# *******X #
# *        #
# * ****** #
# * *    * #
# * * O* * #
# * *  * * #
# * **** * #
# *      * #
# ******** #
#          #
############