###########
#    P    #
# XXXXXXX #
#         #
#* * * * *#
# * * * * #
#* * * * *#
# * * * * #
#* * * * *#
#         #
# OOOOOOO #
#         #
###########