###########
#    P    #
#XXXXXXXXX#
#         #
#  * * *  #
# * * * * #
#* * * * *#
# * * * * #
#  * * *  #
#         #
#OOOOOOOOO#
#         #
###########