     #####     
   ##     ##   
  #         #  
 #  # # # #  # 
 #  #O# #O#  # 
#   ### ###   #
#             #
# X    P    X #
#  XX     XX  #
#  OOXXXXXOO  #
 #  *OOOOO*  # 
 #   *****   # 
  #         #  
   ##     ##   
     #####     