~~###~~~###~~
~#@@@#~#@@@#~
##   ###   ##
#* X  #  X *#
#           #
##         ##
~##       ##~
~~##*   *##~~
~~~##O O##~~~
~^D~##P##~ ^~
~DD~~###~~B ~
~~~~~~#~~~~~~