######################
# O       @          #
#         @    *^ X  #
#         @    ^^*   #
#@@@@@@        ^^*   #
#   ~                #
# ^ ~   P X    O     #
# ^ ~                #
#   ~~~              #
#     ~   @          #
#  ** ~   @          #
# ~~~~~   @       X  #
# ~O      @          #
######################