##########   
#        #   
# X X XOX### 
# X X XOX  # 
#######O##P##
    # OOOO  #
    # #O#   #
    #     ###
    #######  