       #######
      ##OOOO##
     ##OOOO## 
    ##OOOO##  
   ##  X ##   
  ## X  ##    
 ##    ##     
##  X ##      
#### ####     
# X   XP#     
# X   X #     
# XXXXX #     
#       #     
#########     