     ######      
     #    #      
     # XX #      
     #    #      
     ### ##      
       # #  #####
       # #  #   #
########O#### X #
#      OOO      #
# X ####O##### ##
#   #  # #   # # 
#####  # #   # # 
      ## ##  # # 
      #   #### # 
      # XX    O# 
      #   ###### 
      #####      