     ###     
    ## ##    
   ##   ###  
  ##      #  
 ## X*X*X ## 
##  *OOO*  ##
#   XOPOX   #
##  *OOO*  ##
 ## X*X*X ## 
  ##     ##  
   ##   ##   
    ## ##    
     ###     