         #####  
         #   ## 
         #  * # 
########### # ##
#           #  #
#           #X #
#  ##X#######  #
#  # O*OOOO #X #
#  # OOOO*O #  #
#  ####### ##X #
#  # X X XXX X #
#  #          P#
################