#########
#   *   #
# O *   #
#   *   #
#*******#
#   *   #
#   * X #
#   *   #
#########