#####  ####
#   ####  #
# X     X #
## #####  #
 # #  O# ##
 # #OOP   #
## #  O## #
#  ###### #
# X     X #
#  ####   #
####  #####