   #####   
   #   #   
   #   #   
####X X####
#  XOOOX  #
#   OPO   #
#  XOOOX  #
####X X####
   #   #   
   #   #   
   #####   