   #####   
   # P #   
   #   #   
####X X####
#  X   X  #
#OOOO*OOOO#
#  X   X  #
####X X####
   #   #   
   #   #   
   #####   