#####  #########
#   #  #       #
# # ####XX # # #
#OOOOOOOOX     #
### ####XX # # #
  # #  #       #
  # #  #########
  # #           
### ###         
# X X #         
# XXX #         
#     #         
#     #         
#O P O#         
#######         