 ############
##O##       #
#OOO  X X X #
##O#####O####
 #X X X P#   
 #       #   
 #########   