###########
#     #   #
# #*#*#X  #
# *OOO* X #
# #O#O#X  #
# *OOO* X #
###*#*#X  #
# X X X P #
#         #
###########