############      
#       # P#      
#  #### #  #      
#  #  # #  #      
#  #  # #  #      
#  ####    #######
#     OO####     #
#  ###OO     X X #
###### ######    #
#    # #    ######
#    # #    #     
#  ### ###  #     
#           #     
#  # X X #  #     
#  #     #  #     
#############     