      #######      
      #  P  #      
      # # # #      
      #     #      
      # ### #      
      #     #      
      ###X###      
        # #        
######### #########
#                 #
#######     #######
      #     #      
      #     #      
      #  O  #      
      # ### #      
      # # # #      
      # # # #      
      # # # #      
      # # # #      
      # # # #      
      ### ###      