################
#P #   OO#     #
#  #  XOO#  X  #
#  #  #OO#  #  #
# X#XX#XX#XX#X #
#  #  #OO#  #  #
#  X  #OOX  #  #
#     #OO   #  #
################