       #####       
    ####   ####    
    #  #   #  #    
##### X  X  X #####
#      #   #  #   #
# # # X#####X # # #
#      OOOOO  #   #
###################