        ######      
        #    #      
        # X  #      
        #  X #      
##########X  #      
#      # # X #      
# #### ###  X#      
# #  #     X #      
# # *####### #######
#   *    P   OOOOOO#
####*  #############
   # * #            
   #   #            
   #####            