         #####         
         #   #         
         # # #         
#####    # P #    #####
#   ###### # ######   #
# XX#     OOO     #XX #
# X    # #O#O# #    X #
# X #     OOO     # X #
#   ###### # ######   #
#####    #   #    #####
         # # #         
         #   #         
         #####         