###########
#         #
#  #O#O#  #
# XOX XOX #
#  # # #  #
# XOX XOX #
#  #O#O#  #
#    P    #
###########