       #### 
    ####  # 
    #     # 
    #  #  # 
###### # ## 
#      # #  
#   #  # #  
#####X## ###
#P     #   #
###### # # #
     #    O#
     #######