####        
#O ##       
#OO ####### 
# OO  # P # 
## O      ##
 ## # ###  #
  # #  #   #
  #  XX#XX #
  #  # #   #
  #   X X ##
  ##      # 
   ######## 