  ###  
 ##O## 
##OOO##
#OOXOO#
#O X O#
#  #  #
#  X  #
## X ##
#  X  #
# #X# #
#  X  #
## X ##
#  X  #
#  #  #
#  X  #
 # P # 
  ###  