 ####  
 #  ###
## X  #
#  X  #
#OO*OO#
#  X  #
## X  #
 #  ###
 ####  