      #####      
      #   #      
      # X #      
      #   #      
      ## ########
       # #      #
#####  #OX   ## #
#   ####O#####  #
# X    OOO    X #
#   ####O#### X #
#####  # #  #   #
       # #  #####
      ## ##      
      #   #      
      # X #      
      #   #      
      #####      