###########
#   #OOO# #
# XX#O*OP #
#  X OOO# #
# XX## ## #
#  X # #  #
# XX #   ##
#      ### 
########   