  #####          
  #   #          
  # # ###########
  #  OOOOOOOO   #
##### #######XX #
#   #       # X #
# P # X X X # X #
##          # X #
##  ######  #   #
 ####    ########