#############
#    OOO    #
# XXX***XXX #
#    OOO    #
#############