   #####   
   # P #   
   #   #   
####X X####
#  XOOOX  #
#   O*O   #
#  XOOOX  #
####X X####
   #   #   
   #   #   
   #####   