     #####         
     #   # #####   
     # * ###   #   
     #    *  * ####
     ## ####     O#
      #*#  # ######
####### #  #*#     
# P   X #### ##    
# * # *  *    #    
#   #   ### * #    
######### #   #    
          #####    