#####
# P #
#XOX#
#OXO#
#   #
#   #
#####