###############
#     OO*     #
#  XXXO*OXXX  #
#     *OO    P#
###############