###########
#         #
# # # # # #
#  XOXOXO #
# # # # # #
#P XOXOXO #
# # # # # #
#  XOXOXO #
# # # # # #
#         #
###########