       #####       
      ##   ##      
     ##  *  ##     
######  * *  ######
#   #  * * *  #   #
# X   * *P* *   O #
#   #  * * *  #   #
######  * *  ######
     ##  *  ##     
      ##   ##      
       #####       