     #########     
     #   *   #     
######  * *  ######
#   #  * * *  #   #
# X   * *P* *   O #
#   #  * * *  #   #
######  * *  ######
     #   *   #     
     #########     