####        
#  #######  
#        #  
#  ##### ###
#*##   #   #
#  #   # # #
#  * X # # #
## # # # # #
 # # O # # #
 # #   * # #
 # # P # # #
 #     # # #
 ####*#### #
    #      #
    ########