#####   #######
#   #   #     #
# # ##### # # #
#  OX P   #   #
###O####### ###
#  O    X # #  
# # ###   # #  
# # X ##### #  
# # #       #  
# # #########  
#   #          
#####          