 #####    
 #   #####
 # # #   #
 # X OX# #
###O##   #
#   ##O###
# #XO X # 
#   # # # 
#####  P# 
    ##### 