            #### 
            #  # 
 ############* # 
##             # 
#PX  ##### #  ## 
#### #   # ##*#  
 #  *  * #  # #  
 # # # #### # #  
 #   # *  * # #  
 #####  # # # ###
    # * #       #
    #   #####O# #
    #  ##   #   #
    ####    #####