   ###########       
   #  * * *  #       
####   * *   ########
#     * * *  #  # # #
#      * *      X   #
## #  * * *  # # # ##
 # #   * *   #      #
## #  * * *  ## # # #
#  ###########      #
#       O        # ##
#####################