#############
#   *   *   #
# X * * * X #
#   *   *   #
#***********#
#   *   *   #
# O * O * O #
#   *   *   #
#***********#
#   *   *   #
# * * X * * #
#   *   *   #
#############