 #     ##########         
##     # OXOXO  ##        
##     # XOXOX   #        
########POX XO   #######  
##     # XOXOX   #      # 
##     # OXOXO  ##        
 #     ##########        #
                         #