#########
#    ####
# ## ####
#  OXO###
# #XPX###
# #OXO  #
# # ### #
#       #
#########