@@@@@@@@@@@
@ B^   DDD@
@       ^D@
@         @
@ ^       @
@DD      *@
@ *   B   @
@@@@@@@@@@@