@@@@@@@@@@@
@ B^   DDD@
@    P  ^D@
@         @
@ ^       @
@DD      *@
@ *   B   @
@@@@@@@@@@@