@#@#@@#@#@#
#~~~~~~~~~@
@~B      ~#
@~      ^~#
#~     ^ ~@
@~^    B*~#
#~~~~~~~~~@
@#@#@@#@#@#